1111111111111111111111111111111
1P000000000C0000000C00000000001
1111111111100000000001111100001
1000100000110000000100000100001
1000011111010111000011111000001
1000010000010000100000100000001
1000000000001000010000000000001
100000000001000000100000E000001
1000000000100000000100000000001
100000C0001011111110000C0000001
1111111111111111111111111111111