1111111111111111111111111111111
1P00000000000011000000000000001
10C0001111110000001111110000001
1000011000001000010000011000001
100001100000100C0C1000001000001
1010011000001111111000001000001
101001100001C000000100001000C01
1010011000100000E00010001000001
1010C1100100000000C001001000001
1000011110000111000000111000001
1000000C0000000001100000C000001
1111111111111111111111111111111