111111111111111
10010001000C011
10000101C1C0001
10E010100010001
1110001010C0001
10000P10C011101
111111111111111