1111111111111111111111111111111
1P00CC0000000011000000000010001
10C00011111100C0001111110001001
101110100000C000001000011010001
10010010C000100C0C1000001000101
101000100001C000001100001000C01
1011001000100000E00010001000101
1010C010010CC00000C001001001101
1010001110000111000000111000001
1000000C0000000001100000C000001
1111111111111111111111111111111