111111
1P0101
100101
1C1E01
111111