111111
1P1C11
100001
1101E1
111111