11111111111111
1C010C00P000C1
101101C1C01111
1E0000C0000C01
11111111111111