1111111
1C01P01
1010E11
1000101
1110001
1000001
1111111