111111
 P0001
100001
1C0E01
111111