111111
1P0001
10C001
100E01
111111