111111111
1010E0P01
101110001
1C0010001
100C10101
100001001
111111111
