111111111
1P0000001
100E10011
100001101
100C00001
100001001
111101111
