111111111
1P0000001
100E10011
100000001
100C00001
100001001
111111111
