1111111111
1000100001
100C000P01
1000111001
100C001C01
1100000C01
100E000101
1111111111