1111111111
1010E1P001
1011100001
1C00100001
1000101001
1000000001
1C00C001C1
1111111111