1111111111
1000100001
100C000001
10001110C1
100C001C01
11P0000C0C
100E000101
1001000101
1111111111