1111111111
10C001E0P1
1111111A11