11111111111
10EC0000P11
11111111111